11111111
1P111CE1
10CCC011
11111111
